e e e e e e e e e e e e e e e e e e e e
e e e e e e e e e e e e e e e e e e e e
e e e e e e e e e e e e e e e e e e e e
e e e e e e e e e e e e e e e e e e e e
e e e e e e e e e e e e e e e e e e e e
e e e e e e e e e e e e e e e e e e e e
e e e e e e e e e e e e e e e e e e e e
e e e e e e e e e e e e e e e e e e e e
e e e e e e e e e e e e e e e e e e e e
e e e e e e e e e e e c e e e c e e e e
e e e e e e e e e e w w e w e w e e e e
e e e e e e e e e e e e e e e e e e e e
e e e e e e f b b w e e e e e e e e e e
e e e e w b w b w e c b e e e e e e e e
e e b e e e e e e e b b b e e e e e e s
m e e e e e e e f b b b b b c e f e w w
w w w w w w w w w w w w w w w w w w w w
w w w w w w w w w w w w w w w w w w w w
w w w w w w w w w w w w w w w w w w w w
w w w w w w w w w w w w w w w w w w w w